NO textures/wolfenstein/wood.xpm
SO textures/wolfenstein/wood.xpm
WE textures/wolfenstein/wood.xpm
EA textures/wolfenstein/wood.xpm

F 20, 20, 20
C 50, 50, 0

11111111111         11111111111
10000000001         10000000001
1000000000111111111110000000001
1000000000000000000000000000001
1000000000000000000000000000001
1000000001111111111110000000001
1000000001          10000000001
1111000111          11110001111
   1000111111111111111110001
   1000000d0000S0D0000000001
   100011111111D111111110001
11110001111   101   11110001111
10000000001   101   10000000001
100000000011111D111110000000001
1000000000000000000000000000001
1000000000000000000000000000001
1000000000111111111110000000001
10000000001         10000000001
11111111111         11111111111