NO textures/simonkraft/cobblestone.xpm
SO textures/simonkraft/mossy_cobblestone1.xpm
WE textures/simonkraft/cobblestone_01.xpm
EA textures/simonkraft/cobblestone_02.xpm

                                F                      100           ,              100           ,100
C 12,12,12

11111111111
10000000001
10000000001
10000000001
10000N00001  
10000000001
10000000011
11111111111