NO textures/wolfenstein/grey_stone.xpm
                       SO                                  textures/wolfenstein/purple_stone.xpm
WE textures/wolfenstein/red_brick.xpm
EA textures/wolfenstein/wood.xpm

                                F                      220           ,              100           ,0
C 225,30,0

11111111111
100000000N1
10000000001
10000000001
10000000001
10000000001
10000000001
11111111111