NO textures/simonkraft/cobblestone.xpm
SO textures/simonkraft/mossy_cobblestone1.xpm
WE textures/simonkraft/cobblestone_01.xpm
EA textures/simonkraft/cobblestone_02.xpm

F 100,100,100
C 12,12,12

11111111111         11111111111
10000000001         10000000001
1000000000111111111110000000001
1000000000000000000000000000001
1000000000000000000000000000001
1000000001111111111110000000001
1000000001          10000000001
1111000111          11110001111
   1000111111111111111110001
   100000010000S010000000001
   1000111111110111111110001
11110001111   101   11110001111
10000000001   101   10000000001
1000000000111110111110000000001
1000000000000000000000000000001
1000000000000000000000000000001
1000000000111111111110000000001
10000000001         10000000001
11111111111         11111111111