NO textures/wolfenstein/grey_stone.xpm
                       SO                                  textures/wolfenstein/purple_stone.xpm
WE textures/wolfenstein/red_brick.xpm
EA textures/wolfenstein/wood.xpm

F                      15, 15, 15
C 158, 158, 158

1111111
1000001
100N001
100000111111
100000000001
1111111111011111111
         1000000001
         1000000001
         1000000001
         1111111111