NO textures/wolfenstein/grey_stone.xpm
SO textures/wolfenstein/purple_stone.xpm
WE textures/wolfenstein/red_brick.xpm
EA textures/wolfenstein/wood.xpm

D textures/door.xpm

F 33,110,64
C 39,80,138


1111111111111111
1000001000100001
1000001010100001
1000001000100001
1000001DDD100001
1000000N10010001
1000000000000001
1000000000001001
1100000000000011
1100000000000111
1110000000001111
1111111111111111
